linhas 10
colunas 20
moedas 3000
..........++++++++++
..............++++++
................++++
..............++++++
..............++++++
..++.............+++
..++++.............+
..++++.........+++..
.............++++++.
...............+++..